###########################################
#.............................#...........#
#.C......S....................M...........###
#.............................#.............#
#.............########........####..........#
#.............#..C.#M.........#X.#..........#
#.............#...............#..#..........#
###...........##############..##.#..........#
  #.................C#     #..#C............#
  ####################     ##################










